..............X................
..............X................
X.............X...............X
X.............X...............X
X........XX.........XX........X
XX........XX.......XX........XX
XX.............XX............XX
XX.............XX............XX
XX...........................XX
XX...........................XX
XX...........................XX
XXX.........................XXX
XXX.........................XXX
XXX.........................XXX
XXX.........................XXX
XXX.........................XXX
XXXXX.......................XXX
XXX.......................XXXXX
XXX.........................XXX
XXXX.......................XXXX
XXXXXXXXXXXXXXXXXXXXXXXXXXXXXXX
............X.....X............
............X.....X............
............X.....X............
...XXXXXX...X.....X...XXXXXX...
...XXXXXX...X.....X...XXXXXX...
...XXXXXX...X..X..X...XXXXXX...
............X.XXX.X............
XXXXXXXXXXXXXXXXXXXXXXXXXXXXXXX
XXXXXXXXXXXXXXXXXXXXXXXXXXXXXXX
.....X..X..X.......X..X..X.....
1 30
1 0
46
24 3 2 5
24 4 2 5
24 5 2 5
24 6 2 5
24 7 2 5
24 8 2 5
24 22 2 5
24 23 2 5
24 24 2 5
24 25 2 5
24 26 2 5
24 27 2 5
25 3 2 5
25 4 2 5
25 5 2 5
25 6 2 5
25 7 2 5
25 8 2 5
25 22 2 5
25 23 2 5
25 24 2 5
25 25 2 5
25 26 2 5
25 27 2 5
26 3 4 10
26 4 4 10
26 5 4 10
26 6 4 10
26 7 4 10
26 8 4 10
26 15 2 5
26 22 4 10
26 23 4 10
26 24 4 10
26 25 4 10
26 26 4 10
26 27 4 10
27 14 2 5
27 15 2 5
27 16 2 5
30 5 25 50
30 8 25 50
30 11 25 50
30 19 25 50
30 22 25 50
30 25 25 50
0
